11111111111111111110
10000000000000000010
10050000000000000010
10000000000000000020
10000000000000000020
30000000000000000010
10000000000000000010
10000000000000000010
10000000000000000000
10000000000000000000
10000000000000000010
10000000000000000010
10000000000000000010
10000000000000000030
10000400000000000010
10000000000000000020
10000000000000000020
10000000000000000020
11111111111111111110
00000000000000000000
