############
#        O #
#   P   ####
#     O    #
#######    #
#  O ##    #
#    ##  O #
#          #
#    O  XX #
#  O    #  #
############