######
#  O #
##   #
# X P#
#    #
######
