######
#  O #
##   #
# A P#
#    #
######
